unigram	unigram_lower
Locofe	locofe
Oroséf	oroséf
AG	ag
Assurances	assurances
Gohüha	gohüha
S.A.	s.a.
Schreinerei	schreinerei
Magafa	magafa
Fâpod	fâpod
	
Conseils	conseils
financiers	financiers
Sàrl	sàrl
Edom	edom
Elektro	elektro
Oweyü	oweyü
GmbH	gmbh
Efigaw	efigaw
Video	video
Caudo	caudo
Santé	santé
Luvov	luvov
Nuda	nuda
Chemie	chemie
Madego	madego
Lolupi	lolupi
Asapo	asapo
Acob	acob
Photo	photo
Henar	henar
Tucay	tucay
Idiwei	idiwei
Acuwa	acuwa
Idage	idage
Transport	transport
Haf	haf
Anopug	anopug
Fesi	fesi
Tageni	tageni
Käse	käse
Hotel	hotel
Huho	huho
Ahëyoc	ahëyoc
et	et
Finu	finu
Ucoruv	ucoruv
Tools	tools
Ragow	ragow
Asurep	asurep
Teled	teled
&	&
Nehu	nehu
associés	associés
Of	of
Iduy	iduy
Remo	remo
Awusü	awusü
Ovomäg	ovomäg
Tugéo	tugéo
Yit	yit
Ebévi	ebévi
Pupad	pupad
Etepo	etepo
Yuwud	yuwud
Spa	spa
Rilanif	rilanif
Ipogöl	ipogöl
Toreh	toreh
Ayámu	ayámu
Fana	fana
Nodoti	nodoti
Trade	trade
Consult	consult
Nofop	nofop
Fäyof	fäyof
Filmproduktion	filmproduktion
Unumaw	unumaw
Deliy	deliy
Verlag	verlag
Ev	ev
Gâwag	gâwag
Gewâya	gewâya
Egisofe	egisofe
Osis	osis
Urela	urela
Wiyu	wiyu
Ebay	ebay
Föyügi	föyügi
Versicherungen	versicherungen
Asih	asih
Elemud	elemud
Amecia	amecia
Licav	licav
Sesuyî	sesuyî
Vahuret	vahuret
Pulun	pulun
Epev	epev
Inonug	inonug
Uyufi	uyufi
Wolu	wolu
Presseservice	presseservice
Iinep	iinep
Ramup	ramup
Oticö	oticö
Sutum	sutum
Âgurup	âgurup
Lumi	lumi
Vefura	vefura
Cemup	cemup
Ipova	ipova
Uruw	uruw
Davig	davig
Mawöpav	mawöpav
Gupu	gupu
Iivag	iivag
Iguha	iguha
Vaahe	vaahe
Awéf	awéf
Iwacu	iwacu
Ecaom	ecaom
Duwev	duwev
Moto	moto
Walow	walow
Finanz	finanz
Futuv	futuv
Rigaha	rigaha
Wituf	wituf
Wupov	wupov
Voyages	voyages
Medizintechnik	medizintechnik
Farüsag	farüsag
Dufe	dufe
Dr.	dr.
Anoy	anoy
Ewope	ewope
Mawowa	mawowa
Beyé	beyé
Hegac	hegac
Bau	bau
Cisu	cisu
Feton	feton
Hihe	hihe
Naya	naya
Imüb	imüb
Olep	olep
Leponi	leponi
Aros	aros
Basiv	basiv
Iwéwöc	iwéwöc
Orefof	orefof
Bank	bank
Icaro	icaro
Bapem	bapem
Anâpil	anâpil
Umane	umane
Oseoro	oseoro
Oduri	oduri
Dahicili	dahicili
Sun	sun
Widug	widug
Etuc	etuc
Restauration	restauration
Eve	eve
Obipi	obipi
Fisubi	fisubi
Aser	aser
Wace	wace
Auto	auto
Iwe	iwe
Amulöh	amulöh
Orutel	orutel
Vermögensvewaltung	vermögensvewaltung
Fögofo	fögofo
Vunoh	vunoh
Deris	deris
Mode	mode
Ave	ave
Lame	lame
Mowu	mowu
Muvob	muvob
Galot	galot
Ubalo	ubalo
Yole	yole
Icowa	icowa
Usemeg	usemeg
Copy	copy
Rutül	rutül
Codute	codute
Tidi	tidi
Ferig	ferig
Duyaf	duyaf
Formations	formations
Ilen	ilen
Cosar	cosar
Orthopädie	orthopädie
Gigühi	gigühi
Üyihi	üyihi
Uset	uset
Vacÿye	vacÿye
Tebadi	tebadi
Informatik	informatik
Ye	ye
Sport	sport
Suv	suv
Diu	diu
Sefâ	sefâ
Iwohân	iwohân
Valégän	valégän
Syucc	syucc
Onifet	onifet
Igem	igem
Taweb	taweb
International	international
Icafu	icafu
Energie	energie
Cüviy	cüviy
Adevat	adevat
Aluha	aluha
Ehe	ehe
Bofela	bofela
Bis	bis
Cosmetic	cosmetic
Pavöyu	pavöyu
Upafus	upafus
Wuc	wuc
Boulangerie	boulangerie
Egon	egon
Fit	fit
Iwiwi	iwiwi
Uyuce	uyuce
Owon	owon
Näleced	näleced
Orito	orito
Vimot	vimot
Vuvanä	vuvanä
Goyub	goyub
Yawalo	yawalo
Imic	imic
Guböl	guböl
Opopa	opopa
Adeve	adeve
Enuh	enuh
Irib	irib
Alutab	alutab
Iimo	iimo
Tite	tite
Ehebe	ehebe
Wifed	wifed
Woyof	woyof
Tigev	tigev
Papop	papop
Metos	metos
Vite	vite
Ucare	ucare
Guha	guha
Fegu	fegu
Utae	utae
Laha	laha
Cobur	cobur
Leso	leso
Onav	onav
Ohemeg	ohemeg
Oviwuo	oviwuo
Ananam	ananam
Robuh	robuh
Ulibe	ulibe
Fowicoc	fowicoc
Widuno	widuno
Sebac	sebac
Hotin	hotin
Rädiva	rädiva
Bat	bat
Inegu	inegu
Urif	urif
Vifi	vifi
Muya	muya
Mopi	mopi
Gabi	gabi
Eayeluw	eayeluw
Nibâ	nibâ
Huga	huga
Ofob	ofob
Befud	befud
Newi	newi
Uvaboy	uvaboy
Ruh	ruh
Cohâ	cohâ
Rechtsanwalt	rechtsanwalt
Oyirca	oyirca
Ecu&Muvob	ecu&muvob
Livuy	livuy
Taran	taran
Puri	puri
Ufawu	ufawu
Ebalua	ebalua
Fipoh	fipoh
Aru	aru
Dsusi	dsusi
Degbobu	degbobu
Neya	neya
Heboa	heboa
Oyisa	oyisa
Usamot	usamot
Hose	hose
Dental	dental
Ruhef	ruhef
Tamo	tamo
Osini	osini
Wugubep	wugubep
Luihé	luihé
Duve	duve
Yowuwéy	yowuwéy
Efag	efag
Mudübo	mudübo
Esow	esow
Oeyin&Lohu	oeyin&lohu
Acena	acena
Motun	motun
Isuger	isuger
Ilema	ilema
Lohu	lohu
Ale	ale
Tacé	tacé
Nävohow	nävohow
Vaparo	vaparo
Inewup	inewup
Hiemä	hiemä
Ocüd	ocüd
Auyeci	auyeci
unlimited	unlimited
Ihub	ihub
Uniwo	uniwo
Sapib	sapib
Eto	eto
Gowu	gowu
Agitec	agitec
Bîfuce	bîfuce
Ukeusa	ukeusa
Tagofi	tagofi
Uceho	uceho
Iwata	iwata
Lovüt	lovüt
Vilâv	vilâv
Agioc	agioc
Emacite	emacite
Vubis	vubis
Lerin	lerin
Ruule	ruule
Eposo	eposo
Pefera	pefera
Olis	olis
Alesov	alesov
Uwemo	uwemo
Vofeh	vofeh
Roca	roca
Uyavu	uyavu
Ewuhe	ewuhe
Ronaoe	ronaoe
Migu	migu
Hehel	hehel
Seyawö	seyawö
Gicef	gicef
Hapida	hapida
Goituw	goituw
Patui	patui
Idac&Valégän	idac&valégän
Irotâc	irotâc
Uyitoc	uyitoc
Hovay	hovay
Filopaaw	filopaaw
Ibedä	ibedä
Imau	imau
Huw	huw
Awufu	awufu
Ofiro	ofiro
Ropiy	ropiy
Coga	coga
Bohad	bohad
Vaahe&Wesi	vaahe&wesi
Navas	navas
Cuboveg	cuboveg
Fenarö	fenarö
Omawo	omawo
Egoyen	egoyen
Afuvon	afuvon
Cunol	cunol
Tôno	tôno
Bama	bama
Omeso	omeso
Uamom	uamom
Yus	yus
Lom	lom
Edowos	edowos
Omïv	omïv
Egafuso	egafuso
Naniapa	naniapa
Nusö&Pida	nusö&pida
Cogù	cogù
Huwib	huwib
Beg	beg
Huw&Eyaviha	huw&eyaviha
Rafu	rafu
Enit	enit
Uto	uto
Ovoyag	ovoyag
Odidar	odidar
Otâloni	otâloni
Ecam	ecam
Suvü	suvü
Oyohei	oyohei
Dénähu	dénähu
Fanehe	fanehe
Alibe	alibe
Naice	naice
Security	security
Vecita	vecita
Ohboy	ohboy
Gupimu	gupimu
Epega	epega
Dotâd	dotâd
Melu	melu
Events	events
Ruy	ruy
Vader	vader
Cicar	cicar
Gasele	gasele
Lanoma	lanoma
Ifonu	ifonu
Lohi	lohi
Cuhi	cuhi
Opvig	opvig
Hënic	hënic
Cahogi	cahogi
Tiyail	tiyail
Hasiv	hasiv
Idac	idac
Tatit	tatit
Cina	cina
Adiyuw	adiyuw
Mot	mot
Niene	niene
Vesip	vesip
Ihavö	ihavö
Icâgil	icâgil
Neva	neva
Invest	invest
Yäcaf	yäcaf
Wude	wude
Déapif	déapif
Immobilier	immobilier
Yesä	yesä
Yewar	yewar
Esatut	esatut
Bedocu	bedocu
Pora	pora
Arop	arop
Tepôl	tepôl
Epihu	epihu
Cacüo	cacüo
Fimum&Usemeg	fimum&usemeg
Vogüf	vogüf
Wigos	wigos
Fäcoc	fäcoc
Semo	semo
Umefu	umefu
Cilun	cilun
Ftece	ftece
Vumay	vumay
Laf	laf
Läna	läna
Oyuwig	oyuwig
Onaga	onaga
Atoy	atoy
Ufirul	ufirul
Afece	afece
Wirad	wirad
Büda	büda
Ogibi	ogibi
Biyo	biyo
Yopec	yopec
Owed	owed
Mogup	mogup
Cih	cih
Acofo	acofo
Luyi	luyi
Owem	owem
Tinadi	tinadi
Éviwo	éviwo
Hahew	hahew
Huv	huv
Loviw	loviw
Aley	aley
Bogi	bogi
Barelo	barelo
Ifbeta	ifbeta
Gicuhu	gicuhu
Ohiena	ohiena
Ucifi	ucifi
Odutay	odutay
Hixi	hixi
Manopo	manopo
Acig	acig
Alacep	alacep
Ohehh	ohehh
Bobit	bobit
Igar	igar
Niyiho	niyiho
Tobefe	tobefe
Toyar	toyar
Tebuc	tebuc
Agehoh	agehoh
Ope	ope
Beru	beru
Yeru	yeru
Lice	lice
Ovur	ovur
Simir	simir
Uwesac	uwesac
Service	service
Isufe	isufe
Sitan	sitan
Ruvus	ruvus
Nädit	nädit
Hoavuc	hoavuc
Hepeac	hepeac
Aphuh	aphuh
Hinut	hinut
Isiv	isiv
Vati	vati
Riwa	riwa
Ey	ey
Evi	evi
Ecapov	ecapov
Wofuwä	wofuwä
Fiduciaire	fiduciaire
Osuh	osuh
Uten	uten
Vino	vino
Payawo	payawo
Ucomi	ucomi
Ufesoh	ufesoh
Oduc	oduc
Owufi	owufi
Cunur	cunur
Lofe	lofe
Oafay	oafay
Fagus	fagus
Nyof	nyof
Nori	nori
Mäniwu	mäniwu
Danuv	danuv
Fesope	fesope
Totohö	totohö
Lobevu	lobevu
Horï	horï
Öbinul	öbinul
Rayo	rayo
Nebset	nebset
Gâre	gâre
Ceme	ceme
Owofuya	owofuya
Holâm	holâm
Fugi	fugi
Cisec	cisec
Etüvod	etüvod
Hahüg	hahüg
Ofew	ofew
Pah	pah
Uha	uha
Ovewe	ovewe
Nivec	nivec
Afato	afato
Iiha	iiha
Ravog	ravog
Woofa	woofa
Omanï	omanï
Wide	wide
Migoo	migoo
